1111111111
1P00000001
1000C00001
1000000001
1000011001
1000110001
10001E0001
1111111111